ACE - FACE
ACT - FACT
AID - PAID
AIL - SAIL
AIR - FAIR
ALE - TALE
ALL - BALL
ART - CART
BAD - BRAD
BAN - SPAN
BAR - BEAR
BAT - BOAT
BAY - PLAY
BED - SHED
BEE - FREE
BIN - BIND
CAB - SCAB
CAN - SCAN
CAP - CLAP
CAR - SCAR
CAT - COAT
CON - CONE
COW - CROW
CRY - CRAY
DAB - DRAB
DAM - DAME
DEN - DENT
DIN - DINE
EAR - BEAR
EAT - MEAT
EBB - WEBB
ECO - ECHO
EEL - FEEL
ELK - YELK
END - BEND
FAD - FADE
FAN - FANG
FAR - FARM
FAT - FLAT
FEE - FEEL
FOR - FORK
GAL - GALE
GAS - GASP
GEL - GELD
HAD - CHAD
HAG - SHAG
HAL - HALL
HAM - SHAM
HAP - HEAP
HAT - CHAT
HAY - SHAY
HID - HIDE
ICE - DICE
ICE - NICE
ICE - RICE
ICH - RICH
ICK - SICK
ICY - ICKY
ILL - BILL
INK - PINK
JAM - JAMB
JAR - JAAR
JAY - JAYD
KIN - SKIN
KIP - SKIP
KIT - KITE
KIN - KINK
KOI - KOIN
LAB - SLAB
LAD - LEAD
LAG - FLAG
LAP - FLAP
LAW - CLAW
LAY - PLAY
LID - SLID
MAD - MEAD
MAN - MEAN
MAR - MART
MAT - MATE
MOP - MOPE
NAG - SNAG
NAP - SNAP
NET - NEST
NIL - NAIL
NIP - SNIP
NOD - NODE
NOT - NOTE
OAF - LOAF
OAK - SOAK
OAR - BOAR
OAT - BOAT
ODE - CODE
OFF - COFF
OFT - SOFT
PAD - PAID
PAL - PALM
PAN - PANE
PAP - PAPA
PAR - PARK
PAT - PATH
PAW - PAWN
QUA - QUAD
QUA - QUAY
QUA - QUAB
QUI - QUID
QUI - QUIP
QUO - QUOD
RAD - READ
RAG - BRAG
RAN - RAIN
RAP - TRAP
RAT - BRAT
RAW - DRAW
RAY - PRAY
SAD - SAID
SAG - SAGE
SAP - SOAP
SAT - SEAT
SAY - STAY
SEA - SEAT
SON - SONG
TAB - STAB
TAG - STAG
TAP - TRAP
TAR - STAR
TAX - TAXI
TEA - TEAM
TEN - TEND
TIE - TIER
UDO - UNDO
UGH - AUGH
UKE - LUKE
UMP - BUMP
UNI - UNIT
URN - BURN
USE - USER
VAN - VANE
VEE - VEER
VET - VEST
VEX - VEXT
VIE - VIEW
WAD - WADI
WAG - WAGE
WAN - WAND
WAR - WARD
WAX - WAXY
WIN - WINE
XIS - EXIT
XIS - XIST
XED - AXED
XED - EXED
XED - OXED
XED - XEDT
XEN - AXEN
YAW - YAWN
YEA - YEAH
ZOO - ZOOM